12 9
111111111111
100001000001
101100010101
100011010111
101010010101
101010000101
101001110001
100100010101
111111111111