0
12 9
111111111111
100001000001
101100010101
100011010111
101010010101
101010000101
101001110001
100100010101
111111111111

0 1 1 5 1
1 1 2 3
1 2 5 4 2 7
1 4 2 1
2 1 8 1 6 1 2
2 2 2 7 8 1 1