10
15 9
111111111111111
100000000000001
100000000000001
100000000000001
100000000000001
100000000000001
100000000000001
100000000000001
111111111111111

0 -1 -1 1 1
1 4 2 2 1
1 4 3 2 1
1 4 4 2 1
1 4 5 2 1
1 4 9 2 1
1 4 10 2 1
1 4 11 2 1
1 4 12 2 1
1 4 1 3 1
1 4 8 3 1
1 4 1 4 1
1 4 4 4 1
1 4 5 4 1
1 4 8 4 1
1 4 11 4 1
1 4 12 4 1
1 4 1 5 1
1 4 6 5 1
1 4 8 5 1
1 4 2 6 1
1 4 3 6 1
1 4 4 6 1
1 4 5 6 1
1 4 9 6 1
1 4 10 6 1
1 4 11 6 1
1 4 12 5 1