1
15 11
111111111111111
100010000000001
100010000010001
111110000011111
100100000001001
100100111001001
100111101111101
100100101001001
100100111001001
100000000000001
111111111111111

0 7 9 8 2
1 1 7 6
1 2 1 4 13 6
1 2 1 1 7 4
1 2 13 1 7 7
1 2 13 4 3 2
1 2 4 5 4 7 
1 2 10 5 10 7
1 4 12 7
1 4 12 8
2 1 5 1 3 2 3
2 1 9 1 3 2 3
2 2 13 6 1 3 2
