2
19 21
1111111111111111111
1000000001000000001
1011011101011101101
1000000000000000001
1011010111110101101
1000010001000100001
1111011101011101111
1111010000000101111
1111010110110101111
1000000100010000001
1111010111110101111
1111010000000101111
1111010111110101111
1000000001000000001
1011011101011101101
1001000000000001001
1101010111110101011
1000010001000100001
1011111101011111101
1000000000000000001
1111111111111111111

0 9 15 5 1
1 1 9 9
1 4 1 2 4
1 4 17 2 4
1 4 1 15 4
1 4 17 15 4
1 2 1 9 16 9
1 2 17 9 2 9
2 1 9 7 2 1 2
2 1 6 1 2 1 3
2 1 12 1 2 1 3
2 2 2 19 2 1 2
2 2 16 19 2 1 2