2
22 10
1111111111111111111111
1000001100000000110001
1000010010000001001001
1000100000000010000001
1000100000000010000001
1000100110000010011001
1000010010000001001001
1000001100000000110001
1000000000000000000001
1111111111111111111111

0 1 1 3 1